######
#u___#
#____#
#____#
######