###############################
#_____________________________#
#_____________________________#
#_____________________________#
#_____________________________#
#_____________________________#
#_____________________________#
#_____________________________#
#_____________________________#
#_____________________________#
#_____________________________#
#_____________________________#
#_____________________________#
#_____________________________#
#______________u______________#
#_____________________________#
#_____________________________#
#_____________________________#
#_____________________________#
#_____________________________#
#_____________________________#
#_____________________________#
#_____________________________#
###############################
