###############################################################
#_____________________________________________________________#
#_________u_____u____uu__u__uu____u_u__u_____uuuu_____________#
#_______u_____u____uu__u__uu____u_u__u_____uuu________________#
#_______________uuuuuu__________uu______uuu___________________#
#_____________________________________________________________#
#_____________________________________________________________#
#_____________________________________________________________#
#_____________________________________________________________#
#_____________________________________________________________#
#_____________________________________________________________#
#_____________________________________________________________#
#_____________________________________________________________#
#_____________________________________________________________#
###############################################################
